10 10
@.........
#..#......
#..####...
##.#......
...######.
#......#..
#.####.##.
.....#.#..
..#..#.###
..#..#...F