12 10
############
#@   #   # #
###  #   # #
#    ##  # #
#        # #
###### ### #
#        # #
#  ####### #
#          #
############
